..........
..........
........#.
.....####.
----......
-PP-......
----......
......~~..
##.....~~~
..........