..............######
................####
..................##
...P................
..............P.....
......P.............
................~~~~
..-----.......~~~~~~
...--------..~~~~~~~
..--------.....~~~~~
......---.........~~
....................
....................
....................
....................