#########
#.-.....#
#.-.#####
#.......#
#########
