..........
..........
...####...
..........
P........P
~~~~..~~~~
P........P
..........
...####...
..........
..........